10 10
10 10
1 2
6 2 2 X 2 4 X 5 X 3
3 5 5 4 6 4 1 2 X 2
X X 3 2 3 1 1 1 3 1
4 8 3 4 2 1 3 2 2 5
3 3 1 5 2 1 X 2 3 2
2 1 1 2 4 1 4 4 3 1
X 1 2 3 3 X 2 8 X 3
1 2 3 1 1 2 4 1 2 X
4 X 6 X 3 2 1 2 2 4
X 3 2 4 3 1 1 1 1 2
